had = to have
hail = granizo/lluvia
hair = pelo
half = mitad
halting = claudicante
hand = mano 
handle = tocar/manejar
handler/s = manejador
handy = a la mano/próximo
happen = acontecer/suceder/ocurrir
happy = alegre
hard = duro/fuerte/con empeño
has = tercera persona de have
hat = sombrero
have = tener/tener que
hear = oir
heat = calentar
hefty = bastante pesado/fornido/robusto
help = ayudar
her = palabra personal: ella - adjetivo posesivo: su/sus/de ella
here = palabra de local: aquí
hers = pronombre posesivo: suyo/a; el/lo/a-s suyo/a-s
hierarchic = hierarchical/jerárquico
him = palabra personal: él
his = adjetivo y pronombre posesivo: su/sus/suyo
home = hogar
hood = capucha/tapar
hook = gancho/anzuelo
hope = esperar/tener esperanzas de
hot = caliente/tener calor
house = casa
how = palabra interrogativa: ¿cómo?
however = sin embargo/no obstante/por muy/de cualquier modo/como quiera que
hungry = tener hambre
hurt = herir/lastimar
husband = esposo
heavy = pesado
hall = vestíbulo/recibidor/edificio público
himself = reflexivo: se/él mismo
herself = reflexivo: se/ella misma
