sad = triste
safe = seguro/salvo/ileso
said = antes mencionado/antedicho
salt = sal
same = mismo/idéntico/igual/uniforme
sang = pasado de sing
sat = pasado de sit
saturday = sábado
saw = pasado de see
say = decir
school = escuela
scoop = cuchara/paleta
scratch = arañar/rasguñar/raspar
see = ver
seek = buscar/aspirar a/anhelar/tratar de obtener
self = propio/puro/no mezclado
self-contained = autónomo/independiente
sell = vender
send = enviar
sent = pasado de send
set = poner/colocar/establecer/colección
several = diversos/algunos
short = corto
should = auxiliar: obligación condicional (deber)
sibling = hermano/hermana/fraternal/medio hermano
sick = enfermo
side = lado/costado/flanco
sign = firmar
signature = firma
simply = simplemente/sencillamente
since = desde entonces/hace/a partir
sincerely = sinceramente
sing = cantar
single = unico/individual/particular
sit = sentarse
skill = destreza/habilidad/experiencia
skip = saltar
skits = mofa/burla
sleep = dormir
slept = pasado de sleep
slice = separar/dividir
slow = lento/parado/aburrido
slowly = lentamente
small = pequeño
smoke = humo/fumar
snippets = recorte/retazo/persona pequeña
so = asi/de este modo/de esa manera/tan/tanto/de igual manera
sofa = sofá
softly = suavemente
sold = pasado de sell
some = algún/alguno
somebody = alguien
somehow = de algún modo/de alguna manera/por alguna razón
someone = alguien
sometimes = a veces/algunas veces
song = canción
soon = pronto
span = trecho/lapso/transcurso
spanish = español
speak = hablar
specify = especificar/específicamente
spell = deletrear/escribir/significar
spend = gastar
spent = spend
split = partir/quebrar
spoke = pasado de speak
spoon = cuchara
spring = primavera
stair = escalera
standard = estandarte/bandera/patrón/nivel/norma/regla fija/modelo/ejemplo
start = empezar
step = paso
stiff = rígido/inflexible
still = inmovil/fijo/tranquilo/todavía/aún/continuamente
store = tienda
story = cuento
stove = estufa
straightforward = directo
street = calle
strip = pelar/desnudar
student = estudiante
study = estudiar
such = tal/que tal/depende del contexto puede significar: asi
sugar = azúcar
suit = traje (objeto)
suitable = adecuado/apropiado
suite = séquito/comitiva/serie de habitaciones/acompañamiento
summer = verano
sunday = domingo
supply = suministrar/suplir/proporcionar
suppress = suprimir/reprimir/sofocar/aplastar/contener
sweep = barrer
swept = pasado de sweep
swim = nadar
sew = coser
shop = ir de comprar/go shopping
shirt = camisa
shoe = zapato
size = tamaño/medida
skirt = falda
sock = calcetín
save = ahorrar/salvar
show = enseñar/demostrar
sweater = sueter
stand = estar de pie/pararse/enderezarse
shake = sacudir/mover
shoulder = hombro
suitcase = maleta
scissors = tijeras
sister = hermana
sister-in-law = cuñada
son = hijo
son-in-law = yerno
serving = porción de comida/para servir
slight = delgado/flaco/tenue/delicado/leve/escaso
slightly = delicadamente/ligeramente
staring = mirar fijamente
strong = fuerte
suddenly = de repente
sticky = pegajoso/viscoso
staff = personal
