wait = esperar
walk = caminar
wall = pared
wallet = billetera
want = querer
wash = lavar
watch = acción: mirar/objeto: reloj
water = agua
way = via/camino/ruta/manera/modo
weapon = arma
wear = llevar puesto
wednesday = miércoles
weight = peso (objeto)
well = bien
well-suited = apropiado
went = pasado de go
what = qué
where = palabra interrogativa: ¿dónde?
whereas = por tanto/en vista de que/puesto que/considerando que
wherever = donde/dondequiera que/donde sea
whether = si/sea o no sea
whetting = estimulando
which = palabra interrogativa: ¿cuál?/¿cuáles?
white = blanco
who = palabra interrogativa: quién/quiénes
whole = entero/todo/íntegro
whose = palabra interrogativa: de quien es
wide = ancho/con of: remoto
widespread = extendido/general/generalizado/difundido
will = palabra básica que forma el tiempo futuro
window = ventana
winter = invierno
wish = desear
witch = bruja
with = con
within = adentro
without = afuera
woman = mujer
wool = lana
wore = pasado de wear
work = trabajar
worry = preocupar/inquietar
worth = valorado
would = auxiliar: forma el condicional del verbo y expresa cortesía
wrap = enrollar/envolver/cubrir
write = escribir
wrong = malo/impropio
wrote = pasado de write
wife = esposa
weak = débil
worse = peor
worst = el peor
