face = cara
fact = suceso/accion/hecho/realidad/verdad/realmente
fairly = primorosamente/lindamente/absolutamente/claramente
fall = otoño
falt = liso/plano
family = familia
fancier = aficionado/conocedor/soñador/iluso
fancy = inclinación/tendencia/afición/gusto
far = lejos de
fashion = moda/modo/estilo
fast = rápido
feature = aspecto/peculiaridad/característica
feel = sentir
feet = pies
felt = pasado de feel
fence = cerca (objeto)
fewer = pocos/unos cuantos/algunos
fill = llenar
find = encontrar/hallar/dar con
fine = bien/fino
finger = dedo
finish = terminar
fix = componer/arreglar/ordenar
flag = bandera
flavor = sabor
floor = piso (objeto)
flower = flor
folk = gente/parentela/tradicional
follow = seguir
food = comida
foot = pie
for = para
forget = olvidar
forgive = perdonar
forgot = pasado de forget
fork = tenedor
form = forma (objeto)
forth = delante/hacia adelante/en adelante/más alla
forward = adelantado/precoz/delantero/prematuro
found = pasado de find
friday = viernes
friend = amigo/amiga
from = de/desde/por/a causa de
frown = fruncir el ceño/desaprobar/enojarse
fry = freir
furniture = muebles
further = nuevo/adicional
father = padre
father-in-law = suegro
failure = fracaso
farther = más lejos
fresh = fresco
