call = llamar
camera = cámara
can = poder
canon = regla o precepto/criterio
car = carro/coche
care = cuidado/cautela/atención/detenimiento
careful = cuidadoso/cauteloso/prudente
carefully = cuidadosamente
carelessly = descuidadamente
carry = llevar/cargar/transportar
carve = tallar/labrar/esculpir
case = caso/condición/estado
cash = hacer efectivo/cambiar un cheque
cast = moldear
cat = gato
catch = agarrar/coger
caught = pasado de catch
cause = causar (acción)/causa (objeto)
celebrate = celebrar
cent = centavo
certain = cierto/seguro/fijo/indudable
chain = cadena
chair = silla
challenge = retar/desafiar
change = cambiar
charge = cargar a la cuenta
check = cheque
chicken = pollo/gallina
child = niño(a)
choice = opción/alternativa/escogencia/opción
choose = escoger
chose = pasado de choose
chunk = trozo/cantidad grande/persona fornida
church = iglesia
cigarette = cigarrillo
city = ciudad
clash = chocar/colisionar/golpear
class = clase
clean = limpiar
cleanup = limpieza general/erradicación/eliminación
climb = subir/escalar
close = cerrar/cerca
closely = cuidadosamente/atentamente/de cerca
clothes = ropa
coat = abrigo
coke = coca cola
cold = frío/tener frío
colon = símbolo de dos puntos
color = color
comb = acción: peinar/objeto: peine
come = venir
common = comun/corriente/familiar/usual/ordinario/frecuente/general
compare = comparar
complaint = queja/lamento
complete = completar
completion = cumplimiento/terminación
compound = compuesta/o
comprehensive = comprensivo/amplio
congratulate = felicitar
consider = verbo: cosiderar/tomar en cuenta
continue = continuar
conversation = conversación
convey = transportar/acarrear/conducir/llevar
cook = cocinar
correctly = correctamente
cost = costar
cotton = algodón
couch = sofá
could = pasado de can/auxiliar: capacidad, habilidad, posibilidad o permiso
count = contar
country = país/campo
cousin = primo/prima
cross = cruzar
cry = llorar
curly = rizado/crespo
customary = habitual
cut = cortar
