made = pasado de make
magazine = revista
maggot = gusano/capricho/idea persistente
mail = enviar
main = parte principal/punto esencial
make = hacer/crear/confeccionar/formar
man = hombre
many = muchos
marry = desposar/casar/casarse
match = compañero/pareja/igual/copia/comparar
matter = material/asunto
may = posibilidad o permiso/poder
maybe = quizá/acaso/tal vez
me = palabra personal: yo
meal = comida
meaning = significar/querer decir/intentar
measure = medir
meat = carne
medicine = medicina
meet = encontrar/ir a esperar/conocer
met = pasado de meet
might = ser posible que/tener posibilidad
milk = leche
mine = pronombre posesivo: mío/a-s; el/lo/a-s mío/a-s
monday = lunes
money = dinero
most = se usa para superlativos: el más
mother = madre
mother-in-law = suegra
mouth = boca
move = mover/trasladarse
movie = cine/película
must = deber/estar obligado
my = adjetivo posesivo: mi/mis
more = se usa para comparar: más
myself = reflexivo: me/yo mismo
