depth = profundidad
does = hacer/tercera persona -> to do
development = desarrollo
design = idea/concepción/proyecto
draft = desperdicio
domain = dominio
distinguished = distinguidos/notables
default = omisión/descuido/negligencia
deliver = entregar
dealing = proceder/trato/comunicación
dump = descargar/vaciar de golpe/verter
drink = beber/tomar
drive = manejar/conducir
do = hacer/auxiliar de pregunta
dinner = cena
door = puerta
deposit = depositar
doctor = doctor
debt = deuda
dress = vestido
discuss = discutir
dog = perro
dance = bailar
down = abajo
during = durante/mientras
dozen = docena
dollar = dólar
dummy = bobo/estúpido
damage = daño/avería/prejuicio
did = pasado de do
drank = pasado de drink
drove = pasado de drive
due = vencido/debido/merecido
dry = secar
desk = escritorio
dish = plato
daughter = hija
daughter-in-law = nuera
dark = oscuro
difficult = difícil
