ability = capacidad/ingenio/facultad
able = capaz/apto
about = acerca de/sobre
above = sobre/encima
accept = aceptar
accident = accidente
accompany = acompañar
accuracy = exactitud/precisión
admire = admirar
adult = adulto
advised = premeditado
after = después
afterwards = después/en seguida/más tarde
ahead = delante/adelante/al frente/a la cabeza/más allá
albeit = aunque/bien que/no obstante
all = todo
allows = permitir/asignar/conceder/reconocer
almost = casi/por poco/cerca de
already = ya/antes de ahora/desde entonces
also = también
although = aunque/no obstante/aun cuando/a pesar de que
always = siempre
among = entre más de dos
amount = cantidad/importe/suma/monto/equivaler
angry = enojado
another = otro/distinto
answer = contestar
anyone = nadie/cualquiera
appear = aparecer
apple = manzana
application = formulario
apply = aplicar
apply for = solicitar
approach = aproximar/allegar/acercar(se)
around = en torno/alrededor/ a la redonda
arrange = arreglar un asunto/concretar una cita
arrive = llegar
as = como
ask = preguntar/formular
asset = posesión/propiedad
at = a/en
ate = pasado de eat
attempt = ensayo/intento
attend = asistir
automate = automatizar/automático
available = disponible
avoid = evitar/aludir
aware = consciente/enterado/informado
away = adverbio: lejos/a lo lejos/a distancia
axis = eje
address = dirección
arm = brazo
aunt = tía
average = promedio
awhile = por un rato
