table = mesa
take = coger o tomar un objeto/llevar una persona
tale = cuento
talk = hablar
tall = alto
tank = tanque
target = blanco/objetivo
task = tarea
taught = pasado de teach
teach = enseñar
teacher = maestro(a)
telephone = teléfono
television = televisor
tell = decir/contar
than = que (comparativo)
that = identificador: ese/esa -> demostrativo: que
the = el/la
their = adjetivo posesivo: de ellos/de ellas/sus/neutro
them = palabra personal: ellas/ellos
then = entonces
there = allí
therefore = por lo tanto/por consiguiente/en consecuencia/debido a eso
thereof = de eso
these = identificador: estos/estas
thin = delgado
third = tercero
thirsty = tener sed
this = identificador: este/esta
those = identificador: esos/esas
though = aunque/aun cuando
through = preposición: por/a través/de un extremo a otro
thursday = jueves
thus = asi/de este modo/de ese modo/por ejemplo
tier = hilera/fila
time = tiempo
tire = llanta
tired = cansado
to = sentido de dirección -> a
today = hoy
told = pasado de tell
tomorrow = mañana
tonight = esta noche
too = también/demasiado
took = pasado de take
touching = emocionante/en cuanto a
toward = próximo/s -> hacia/en la dirección de
trace = pista/huella/línea de registro
track = huella/pisada
train = tren
traverse = recorrer/atravesar
treat = tratar
tree = árbol
trick = truco
tried = probado/seguro/confiable
trip = viaje
truck = camión
trunk = baúl del carro
try = probar/tratar/intentar
tuesday = martes
turn = doblar/voltear
twice = dos veces/doblemente
twists = torcer/doblegar
toe = el dedo del pie
theirs = pronombre posesivo: suyo/a-s; el/lo/a-s suyo/a-s
toy = juguete
tools = herramientas
towel = toalla
toggle = fiador atravesado/palanca acodada
town = pueblo/poblado/población
themselves = reflexivo: se/el/ellas mismos/as/neutro
