package = paquete
paint = pintura (objeto)/pintar (acción)
pair = pareja/emparejar
park = estacionar
parrot = loro/cotorra
parse = analizar
patient = paciente
pay = pagar
pay check = cheque
perform = ejecutar/hacer/realizar
performance = ejecución/realización
perhaps = tal vez/quizá/acaso
period = periodo/fase/etapa/punto
permit = permitir
pick up = recoger/levantar
picture = retrato/foto
play = jugar/tocar un instrumento musical
pointers = indicador/índice
powerful = poderoso/potente
practice = practicar
preface = prólogo/precursor
prepare = preparar
pretty = bonito/hermoso/lindo/bello/elegante/pulcro
price = precio
problem = problema
pun = juego de palabras
purchase = compra
parent = padres (mamá y papá)
pen = pluma/bolígrafo
pepper = pimienta
party = fiesta (objeto)
put = poner/put on -> ponerse
plate = plato
plenty = bastante
pound = libra (peso)
pint = pinta (medida)
people = gente
plot = plano/diagrama/complot/conspiración
pants = pantalones
purse = bolsa
pipeline = tubería/conducto/fuente confidencial de información
point = acción: apuntar/objeto: punto
pencil = lápiz
pet = mascota/animal de casa
perfect = perfecto
poorly = pobremente
pocket = bolsillo
