baby = bebé
back = espalda
backwards = vuelto/dirigido hacia atrás
bad = malo/mal
badly = gravemente/muy mal
baldheaded = calvo
baseball = beisbol
basis = base/fundación/elemento principal
batch = número o cantidad de cosas que se reciben
be = ser/estar/auxiliar de tiempo continuo y futuro inmediato
becomes = convertirse/volverse
before = antes
began = pasado de begin
begin = empezar
behavior = proceder/funcionamiento
being = ser/ente/criatura/de to be/puesto que/ya que
believe = creer
belong = pertenecer/corresponder
below = abajo
belt = cinturón/faja
bend = doblar
besides = además
between = entre dos
beware = estar alerta/cuidarse/guardarse
bicycle = bicicleta
big = grande
bill = cuenta/cobro/factura
bind = amarrar/atar/liar/enlazar/unir/ligar
birthday = cumpleaños
black = negro
blank = vacío
blanket = cobija
blouse = blusa
blue = azul
book = libro
boot = clazar/importar/preparar
boring = perforar/aburrido
born = adjetivo: nacido/de nacimiento/por naturaleza
borrow = pedir prestado
both = ambos/los dos
bother = molestar(se)/incomodar(se)/inquietar(se)/preocupar(se)
bought = pasado de buy
bound = límite
boundary = frontera
boyfriend = novio
braces = animar/reforzar/preparar
bread = pan
breakfast = desayuno
brief = breve/corto/conciso/sumario/resumen
bring = traer
brother = hermano
brother-in-law = cuñado
brought = pasado de bring
browse = hojear/curiosear
brush = acción: cepillar/objeto: cepillo
buffer = amortiguador/parachoques
build = construir
builder = constructor
building = edificio si es un objeto/construyendo si es una acción
built = pasado de build
built-in = incorporado
built-up = desarrollado
bulk = verbo: apilar/rellenar/amontonar - objeto: bulto/carga
bunch = racimo/manojo
bus = autobús
butcher = carnicero
button = botón
buy = comprar
by = por
beard = barba
better = mejor
best = el mejor
beautiful = lindo/bello
birth = nacimiento/parto/origen/principio
