earlier = más temprano/antes/anterior/antiguo
early = temprano
earn = ganar
eat = comer
effective = efectivo/eficiente
either = cualquiera de los dos/ambos
employee = empleado
employer = patrón
enclosed = rodear/incluir
encourage = animar/alentar/fortalecer
english = inglés
enjoy = gozar
enough = basta/suficiente
enter = entrar
entirety = totalidad
erase = borrar/raer/tachar/remover/suprimir
even = parejo/regular/listo/igual/uniforme/+ if aun cuando
every = cada
examine = examinar
exchange = cambiar/canjear/permutar
explain = explicar
employ = emplear
expect = esperar/contar con
ever = adverbio: siempre/poder/nunca jamás
endless = infinito/interminable/eterno
ensure = garantizar/asegurar
ear = oreja
eye = ojo
entirely = completamente/enteramente/totalmente
expensive = caro
