release = soltar/desprender
raise = levantar/erigir
related = relacionado/afín
rapid = rápido/veloz
rearrange = volver a arreglar/ordenar/disponer
rather = de preferencia/preferiblemente
resembles = asemejarse/semejante a
retrive = recuperar/cobrar
request = ruego/súplica/encargo/pretición/solicitud
regardless = despreocupado/indiferente
regard = mirar con atención/contemplar
read = leer
radio = radio
remember = recordar/acordarse de
rent = alquilar
repay = reembolsar/pagar otra vez
repair = reparar
room = cuarto/habitación
rest = descansar
return = regresar/volver
restaurant = restaurante
ride = andar a/andar en
roof = techo
roast = asar
red = rojo
receive = recibir
rode = pasado de ride
raincoat = impermeable
render = rendir/entregar/dar/hacer/producir
record = disco
round = redondo
rapidly = rápidamente
