language = lenguaje/idioma
last = último/final/terminal
late = tarde
later = más tarde/enseguida
laugh = reir
law = ley
lead = plomo/guiar/liderar/conducir/mover
learn = aprender
least = menor/íntimo/mínimo
leave = salir de/dejar
left = pasado de leave
leg = pierna
lend = prestar
less = menor/menos
lesson = lección
let = permitir/sacar/dar/asignar/dejar
letter = carta/letra
light = luz/claro/ligero
lightweight = de poco peso/ligero
like = palabra básica: gustar/conjunción: como
little = poco
live = vivir
lock = echar llave
long = largo
look = mirar/look for -> buscar
lose = perder
lost = pasado de lose
lot = lote/parte/porción
loudly = alta voz/recio
love = amar/querer/encantarle a uno
luck = suerte
lunch = almuerzo
